███████████████████████████████████████████████████████
█         █         █         █     █   █     █       █
███████   █         █   █ █   █  ████   █ ██  ██████  █
█           ██   ██ █         █                       █
█  ██       ██   ██ █  ████   █  █████  ████          █
█                      █                   █    █     █
█  ████   ████     █████      █████             █     █
█     █         █             █                 █ █   █
█  ██ ███   █   █████   ███   █████   █████████ █ █   █
█           █                         █         █     █
██████   ██   ███████ ███████     █       █████████████
█             █                   █                   █
█   ███████   █     ███████  ██████       █  █  █  ████
█                         █               █  █  █     █
█   █████       ███   ██  █  ██████████   ████  █     █
█ █     █       █                         █           █
█ █     █ ██  █ ███   ██            ███   █   █   █   █
█       █     █               ███   █     █   █   █   █
█       ███████    ██       █████   █ ██  █   █       █
█     █                             █         █       █
███████████████████████████████████████████████████████